R 1500 100000
NO ./textures/redbrick.xpm
SO ./textures/stone.xpm
WE ./textures/eagle.xpm
EA ./textures/grass.xpm
S ./textures/pillar.xpm
F 200 200 200
C 200 200 200

   1111  111111111111111111111111
   100111100000000000000000000001   11111
   100000000011111111000000000001   10001
111100000000010000011000000000001   10001
100001001000010000110000000000001   10001
100000000000011000100000000000001   11111
100100000010001000100000111111111
1000000000000010001111101
111111100011111000000010111111111
    100010000000000010000000001
    11101110000000000011111000111                       1111111
      111000000100001001       11111111111              1002001
111111110000000000000001  2        00000011             1100011
120000000000000101010001 2         100000011111111111111111011
111111111111100000000001   2       10000000000000000000000001
            100001S00001        2  10000001111111111111111111
            100000000001   2   2  210000001
1111111111111001000000011111111111110000001
1000000000000000000000000000000000000000001
1000000000000000000000000000000111111111111
11111111111110000011111111111111
            1000001
            1000001
            1111111
            
