R 600 600
NO ./textures/redbrick.xpm
SO ./textures/stone.xpm
WE ./textures/eagle.xpm
EA ./textures/grass.xpm

S ./textures/pillar.xpm
F 0 200 0
C 0 200 0

   1111
   1001  111111111111111111111111
   100111100000000000000000000001
   100000000011111111000000000001
111100000000010000011000000000001
100000000000010000110000000000001
100000000000011000100000000000001
100000000000001000100000111111111
1000000000000010001000001        
111111100011111000000000111111111
      100010000000W00000000000001
      101110000000000001111111111
      111000200100010001
111111110000000000000001
100000000000000101010001
111111111111100000000001
            100000000001
            100000000001
11111111111110000000000111111111
10000000000000000000000000000001
10000000000000000000000000000001
11111111111110000011111111111111
            1002001
            1000001
            1111111
            