R 800 800
NO ./textures/metal.xpm
SO ./textures/stone.xpm
WE ./textures/wall1.xpm
EA ./textures/grass.xpm

S ./textures/grass.xpm
F 220,100,0
C 225,30,0

111111111111111111111111
100000000000000000000001
100000000000000000000001
100000000000000000000001
100000111110000101010001
100000100010000000000001
100000100010000100010001
100000100010000000000001
100000110110000101010001
100000000000000000000001
100000000000000000000001
100000000000000000000001
100000000000000000000001
100000000000000000000001
100000000000000000000001
100000000000000000000001
111111111000000000000001
110100001000000000000001
110000101000000000000001
11010000100000000000N001
110111111000000000000001
110000000000000000000001
111111111000000000000001
111111111111111111111111